Andreas Hundt
8
*****************
*0      6      2*
* *+*+*+*+*+*+* *
* +++++++++++++ *
* *+*+*+*+*+*+* *
* +++++++++++++ *
*4*+*+*+*+*+*+*5*
* +++++++++++++ *
* *+*+*+*+*+*+* *
* +++++++++++++ *
* *+*+*+*+*+*+* *
*3      7      1*
*****************