Nobody
8
******************
*++++++++++++++++*
*++++++++++++++++*
*++oooooooooooo++*
*++o1SS4SS5SS2o++*
*++oSSSSSSSSSSo++*
*++oSSSSSSSSSSo++*
*++oSSSSSSSSSSo++*
*++oSSSSSSSSSSo++*
*++o0SS7SS6SS3o++*
*++oooooooooooo++*
*++++++++++++++++*
*++++++++++++++++*
******************
